XXXXXXXX
XX  X  E
X   XXXX
XX  X  X
S     XX
XXXXXXXX