XXXSXXXXXX
XXX  X   X
XXXX   X X
XXXX XX  X
XXXX  X  X
XX    XX X
XX XXX   X
XX X   XXX
XX   X   X
XXXXXXXXEX