XXXXXXXXEXXXXX
XXXXXX    X  X
X XX X  X XX X
X X  XX X XX X
X X XXX  XX  X
X X      X   X
X X  XX  XX  X
X    X   XX  X
X  X X  XX   X
X  XXXX   XX X
XX   XXX XX  X
XXX          S
XX    XXX  XXX
X X XXX   X  X
XXXXXXXXXXXXXX