XXXXEX
XX   X
XX  XX
S   XX
X  XXX
XXXXXX